#SampleID	BarcodeSequence	LinkerPrimerSequence	Description
1AA	AGACGTTGCTAC	CCGGACTACHVGGGTWTCTAAT	E. triangulatus female body
1AB	TCAATGACCGCA	CCGGACTACHVGGGTWTCTAAT	E. triangulatus female body
1AC	GTCGCTTGCACA	CCGGACTACHVGGGTWTCTAAT	E. triangulatus female body
1AD	ATCGTGTGTTGG	CCGGACTACHVGGGTWTCTAAT	E. triangulatus female body
1AE	TATAGGCTCCGC	CCGGACTACHVGGGTWTCTAAT	E. triangulatus female body
1AGA	AAGCGTACATTG	CCGGACTACHVGGGTWTCTAAT	E. triangulatus female gut
1AGB	CTCGTTTCAGTT	CCGGACTACHVGGGTWTCTAAT	E. triangulatus female gut
1AGC	ACGCTGTCGGTT	CCGGACTACHVGGGTWTCTAAT	E. triangulatus female gut
1AGD	TAGTGCATTCGG	CCGGACTACHVGGGTWTCTAAT	E. triangulatus female gut
1AGE	TCTGGGCATTGA	CCGGACTACHVGGGTWTCTAAT	E. triangulatus female gut
1EA	CTAGCAGTATGA	CCGGACTACHVGGGTWTCTAAT	E. triangulatus egg
1EB	ATCGAATCGAGT	CCGGACTACHVGGGTWTCTAAT	E. triangulatus egg
1EC	TTAAACCGCGCC	CCGGACTACHVGGGTWTCTAAT	E. triangulatus egg
1ED	CTTGCATACCGG	CCGGACTACHVGGGTWTCTAAT	E. triangulatus egg
1EE	AATATCGGGATC	CCGGACTACHVGGGTWTCTAAT	E. triangulatus egg
1LGA	AGAATAGCGCTT	CCGGACTACHVGGGTWTCTAAT	E. triangulatus larval gut
1LGE	ACGTGAGGAACG	CCGGACTACHVGGGTWTCTAAT	E. triangulatus larval gut
1MA	CGGATTGCTGTA	CCGGACTACHVGGGTWTCTAAT	E. triangulatus maternal gift
1NA	GTTATGACGGAT	CCGGACTACHVGGGTWTCTAAT	E. triangulatus brood ball
1NB	GAAAGGTGAGAA	CCGGACTACHVGGGTWTCTAAT	E. triangulatus brood ball
1NC	GAATATACCTGG	CCGGACTACHVGGGTWTCTAAT	E. triangulatus brood ball
1ND	CCAATGATAAGC	CCGGACTACHVGGGTWTCTAAT	E. triangulatus brood ball
1NE	CTTCCGCAGACA	CCGGACTACHVGGGTWTCTAAT	E. triangulatus brood ball
1RA	GGTACTGTACCA	CCGGACTACHVGGGTWTCTAAT	untreated dung
1RB	TCAGGACGTATC	CCGGACTACHVGGGTWTCTAAT	untreated dung
1RC	AGCCTCATGATG	CCGGACTACHVGGGTWTCTAAT	untreated dung
1RD	GTGTATCGCCAC	CCGGACTACHVGGGTWTCTAAT	untreated dung
1RE	TGAATCGAAGCT	CCGGACTACHVGGGTWTCTAAT	untreated dung
2AAF	ACCCTATTGCGG	CCGGACTACHVGGGTWTCTAAT	E. intermedius female body
2ABF	ATGTTTAGACGG	CCGGACTACHVGGGTWTCTAAT	E. intermedius female body
2ABM	GAAACGGAAACG	CCGGACTACHVGGGTWTCTAAT	E. intermedius male body
2ACF	CAAGCGTTGTCC	CCGGACTACHVGGGTWTCTAAT	E. intermedius female body
2ADF	CGTCGTCTAAGA	CCGGACTACHVGGGTWTCTAAT	E. intermedius female body
2AEF	GGTCGTGTCTTG	CCGGACTACHVGGGTWTCTAAT	E. intermedius female body
2AEM	TTACGTGGCGAT	CCGGACTACHVGGGTWTCTAAT	E. intermedius male body
2AGAF	GACCGATAGGGA	CCGGACTACHVGGGTWTCTAAT	E. intermedius female gut
2AGAM	CTCGGTCAACCA	CCGGACTACHVGGGTWTCTAAT	E. intermedius male gut
2AGBF	GGCGAACTGAAG	CCGGACTACHVGGGTWTCTAAT	E. intermedius female gut
2AGBM	CAAGTCGAATAC	CCGGACTACHVGGGTWTCTAAT	E. intermedius male gut
2AGCF	CGGCACTATCAC	CCGGACTACHVGGGTWTCTAAT	E. intermedius female gut
2AGCM	CTGGTCTTACGG	CCGGACTACHVGGGTWTCTAAT	E. intermedius male gut
2AGDF	TGCGGGATTCAT	CCGGACTACHVGGGTWTCTAAT	E. intermedius female gut
2AGDM	TTAGACTCGGAA	CCGGACTACHVGGGTWTCTAAT	E. intermedius male gut
2AGEF	TTAAGCGCCTGA	CCGGACTACHVGGGTWTCTAAT	E. intermedius female gut
2AGEM	CAAACTGCGTTG	CCGGACTACHVGGGTWTCTAAT	E. intermedius male gut
2EA	CATTTCGCACTT	CCGGACTACHVGGGTWTCTAAT	E. intermedius egg
2EB	ACATGTCACGTG	CCGGACTACHVGGGTWTCTAAT	E. intermedius egg
2EC	TGTACGGATAAC	CCGGACTACHVGGGTWTCTAAT	E. intermedius egg
2ED	GCAAGTGTGAGG	CCGGACTACHVGGGTWTCTAAT	E. intermedius egg
2LGB	ATTCCCAGAACG	CCGGACTACHVGGGTWTCTAAT	E. intermedius larval gut
2LGC	ACCACCGTAACC	CCGGACTACHVGGGTWTCTAAT	E. intermedius larval gut
2LGD	GTGAGGGCAAGT	CCGGACTACHVGGGTWTCTAAT	E. intermedius larval gut
2MA	AATCAACTAGGC	CCGGACTACHVGGGTWTCTAAT	E. intermedius maternal gift
2MB	GTGACGTTAGTC	CCGGACTACHVGGGTWTCTAAT	E. intermedius maternal gift
2MC	TCGTCGCCAAAC	CCGGACTACHVGGGTWTCTAAT	E. intermedius maternal gift
2ME	GACTTATGCCCG	CCGGACTACHVGGGTWTCTAAT	E. intermedius maternal gift
2NA	CTTTAGCGCTGG	CCGGACTACHVGGGTWTCTAAT	E. intermedius brood ball
2NB	CACGTTTATTCC	CCGGACTACHVGGGTWTCTAAT	E. intermedius brood ball
2NC	CGTACCAGATCC	CCGGACTACHVGGGTWTCTAAT	E. intermedius brood ball
2ND	TGAGTTCGGTCC	CCGGACTACHVGGGTWTCTAAT	E. intermedius brood ball
2NE	AACATGCATGCC	CCGGACTACHVGGGTWTCTAAT	E. intermedius brood ball
